BKCH=中国银行
ABOC=农业银行
ICBK=工商银行
PCBC=建设银行
PSBC=邮政储蓄
COMM=交通银行
CMBC=招商银行
SZDB=平安银行
CIBK=中信银行
MSBC=民生银行
GDBK=广发银行
SPDB=浦发银行
FJIB=兴业银行
EVER=光大银行
ZJCB=浙商银行
CTBA=澳大利亚联邦银行
ANBK=鞍山银行
ANZB=澳新银行
NOLA=北德意志州银行
CHBH=渤海银行
BRCB=北京农村商业银行
BJCN=北京银行
BARC=巴克莱银行
BARB=巴罗达银行
KRED=比利时联合银行
BTCB=包商银行
CDRC=成都农村商业银行
CBOC=成都银行
CSCB=常熟农村商业银行
DDBK=丹东银行
CRLY=东方汇理银行
DGCB=东莞银行
UOVB=大华银行
DLCB=大连银行
DSBA=大新银行
DECC=德阳银行
BEAS=东亚银行
DYSH=东营银行
DEUT=德意志银行
FSBC=富邦华一银行
KCCB=富滇银行
BNPA=法国巴黎银行
NATX=法国外贸银行
SGCL=法国兴业银行
PNBP=富国银行
FZCB=福建海峡银行
FXBK=阜新银行
GDHB=广东华兴银行
RCNH=广东南海农村商业银行
RCCS=广东顺德农村商业银行
SDBC=国家开发银行
GLBK=桂林银行
CZNB=国民银行
BGBK=广西北部湾银行
GYCB=贵阳银行
GZRC=广州农村商业银行
BKGZ=赣州银行
GZCB=广州银行
BKSH=河北银行
BKHD=邯郸银行
HCCB=哈尔滨银行
HSBC=汇丰银行
KODB=韩国产业银行
SHBK=韩国新韩银行
WHCB=汉口银行
INGB=荷兰安智银行
RABO=荷兰合作银行
DRCB=黑龙江东宁农村商业银行
EWBK=华美银行
CITI=花旗银行
OCBC=华侨银行
HASE=恒生银行
CNMB=华商银行
HXBK=华夏银行
HNBN=韩亚银行
HRCN=惠州农村商业银行
HZCB=杭州银行
JHCB=金华银行
BOJJ=九江银行
HCRR=吉林珲村农村商业银行
JTCB=吉林九台农村商业银行
JLBK=吉林银行
NOSC=加拿大丰业银行
ROYC=加拿大皇家银行
BKJN=济宁银行
DYCB=江苏丹阳农村商业银行
HRCB=江苏海安农村商业银行
HMCB=江苏海门农村商业银行
RCWJ=江苏靖江农村商业银行
JYCB=江苏江阴农村商业银行
JRCB=江苏姜堰农村商业银行
NRCB=江苏南通农村商业银行
PZCB=江苏邳州农村商业银行
RRCB=江苏如东农村商业银行
RGCB=江苏如皋农村商业银行
JSCB=江苏射阳农村商业银行
WJRB=江苏吴江农村商业银行
JYHR=江苏盐城黄海农村商业银行
BOJS=江苏银行
JSHB=晋商银行
URCC=江苏宜兴农村商业银行
YZRC=江苏扬州农村商业银行
JRZC=江苏紫金农村商业银行
BOJX=嘉兴银行
CIYU=集友银行
JZCB=锦州银行
CKLB=昆仑银行
BOLF=廊坊银行
LJBC=龙江银行
LSCC=乐山市商业银行
LWCB=莱商银行
LYCB=临商银行
LCOM=辽阳银行
BOLY=洛阳银行
LZCB=兰州银行
LZBK=柳州银行
CHAS=摩根大通银行
BOFO=美国建东银行
MSBK=摩根士丹利国际银行
NAGO=民古屋银行
BOFA=美国银行
MBBE=马来亚银行
BOFM=蒙特利尔银行
DHBC=宁波东海银行
BINH=宁波通商银行
BKNB=宁波银行
NCCC=南充市商业银行
NCCK=南昌银行
NJCB=南京银行
HSSY=内蒙古银行
YCCB=宁夏银行
NYCB=南洋商业银行
BNYM=纽约银行
SSVB=浦发硅谷银行
BKKB=盘谷银行
QDRC=青岛农村商业银行
QCCB=青岛银行
BOXN=青海银行
JNSH=齐鲁银行
ZBBK=齐商银行
IBKO=企业银行
QRCB=泉州农村商业银行
BKQZ=泉州银行
ESSE=瑞典北欧斯安银行
CRES=瑞士信贷银行
UBSW=瑞士银行
MHCB=瑞穗银行
RZCB=日照银行
SGRB=山东寿光农村商业银行
MBTC=首都银行
ZDRB=山东张店农村商业银行
ABNA=苏格兰皇家银行
SHRC=上海农村商业银行
BOSH=上海银行
SYCB=盛京银行
SMBC=三井住友银行
BOTK=三菱东京日联银行
IBXH=厦门国际银行
RCXM=厦门农村商业银行
CBXM=厦门银行
YDBK=陕西药都农村商业银行
SXCB=绍兴银行
SRCC=深圳农村商业银行
BHRC=天津滨海农村商业银行
TJRC=天津农村商业银行
TCCB=天津银行
BOTS=唐山市商业银行
TZBK=台州银行
WRCB=潍坊农村商业银行
WFCB=潍坊银行
WRCC=武汉农村商业银行
KOEX=外换银行
WHBK=威海银行
UCCB=乌鲁木齐商业银行
HFCB=徽商银行
WZCB=温州银行
IXAB=西安银行
CBNB=协和银行
DBSS=新加坡发展银行
COXI=新联商业银行
WPAC=西太平洋银行
YBRC=延边农村商业银行
BCIT=意大利联合圣保罗银行
BROM=意大利联合信贷
WIHB=永亨银行
YKCB=营口银行
HVBK=友利银行
ZFRB=烟台农村商业银行
CRCK=长春农村商业银行
SCBL=渣打银行
ICBC=兆丰国际商业银行
EIBC=中国进出口银行
ADBN=中国农业发展银行
CTCB=中国信托银行
ZRCB=珠海农村商业银行
CZCB=浙江稠州银行
HCRC=浙江禾城农村商业银行
YHBK=浙江杭州余杭农村商业银行
ZJMT=浙江民泰商业银行
ZJTL=浙江泰隆商业银行
LCBK=浙江温州鹿城农村商业银行
ZXBK=浙江新昌农村商业银行
YWBK=浙江义乌农村商业银行
ZJRB=浙江诸暨农村商业银行
ZJPT=浙江舟山普陀农村商业银行
CQRB=重庆农村商业银行
CTGB=重庆三峡银行
CQCB=重庆银行
CHCC=长沙银行
ZXBC=正信银行
ZZBK=郑州银行
WEBANK=深圳前海微众银行
MSBANK=温州民商银行
KCBANK=天津金城银行
MYBANK=浙江网商银行
SHRB=上海华瑞银行
FMBANK=重庆富民银行
XWBANK=四川新网银行
SXBANK=湖南三湘银行
XABANK=安徽新安银行
ONEBANK=福建华通银行
ZBANK=武汉众邦银行
ZGCBANK=北京中关村银行
SNBANK=江苏苏宁银行
BOBANK=威海蓝海银行
NUBANK=辽宁振兴银行
YLBANK=吉林亿联银行
HBRCB=河北省农村信用社联合社
SXRCB=山西省农村信用社联合社
FDBANK=富滇银行
YNCB=云南农村商业银行
JNCB=江南农村商业银行
XZCB=徐州农村商业银行
RCC=内乡县农村信用合作联社
9999=其他(如第三方支付牌照)